NO ./texture/direction/std_wall_n.xpm
SO ./texture/direction/std_wall_s.xpm
WE ./texture/direction/std_wall_w.xpm
EA ./texture/direction/std_wall_e.xpm
F 110,100,0
C 114,30,0
        1111111111111111111111111
        1000000000110000000000001
        1011000001110000001000001
        1001000000000000000000001
111111111011000001110000000000001
100000000011000001110111101111111
11110001111111000000000000001
11110001111111011101010010001
11000000110101011100000010001
10001000000000000000000000001
10001000000000000000000000001
10001000000000000000000000001
10001000000000000000000000001
10001000000000000000000000001
10001000000000000000000000001
10001000000000000000000000001
10001000000000000000000000001
10001000000000000000000000001
10001000000000000000000000001
10001000000000000000000000001
10001000000000000000000000001
10001000000000000000000000001
10001000000000000000000000001
10001000000000000000000000001
10001000000000000000000000001
10001000000000000000000000001
10001000000000000000000000001
10001000000000000000000000001
10001000000000000000000000001
10001000000000000000000000001
10001000000000000000000000001
10001000000000000000000000001
10001000000000000000000000001
10001000000000000000000000001
10001000000000000000000000001
10001000000000000000000000001
10001000000000000000000000001
10001000000000000000000000001
10001000000000000000000000001
10001000000000000000000000001
10001000000000000000000000001
10001000000000000000000000001
10001000000000000000000000001
10001000000000000000000000001
10001000000000000000000000001
10001000000000000000000000001
10001000000000000000000000001
10001000000000000000000000001
10001000000000000000000000001
10001000000000000000000000001
10001000000000000000000000001
10001000000000000000000000001
10001000000000000000000000001
10001000000000000000000000001
10001000000000000000000000001
10001000000000000000000000001
10001000000000000000000000001
10001000000000000000000000001
10001000000000000000000000001
10001000000000000000000000001
10001000000000000000000000001
10001000000000000000000000001
10001000000000000000000000001
100000000000000110101000N0001
110000011101010111110111100111
11110111 1110101 101111010001
11111111 1111111 111111111111
