NO ./texture/direction/std_wall_n.xpm
SO ./texture/direction/std_wall_s.xpm
WE ./texture/direction/std_wall_w.xpm
EA ./texture/direction/std_wall_e.xpm
F 110,100,0
C 114,30,0
111111111
100000001
100010001
11110111
11110111
110000001
1000N0001
111111111
