NO ./texture/direction/std_wall_n.xpm
SO ./texture/direction/std_wall_s.xpm
WE ./texture/direction/std_wall_w.xpm
EA ./texture/direction/std_wall_e.xpm
S ./texture/barrel.xpm
C 0,0,255
F 255,0,0
11111111111
10000001221
10002001001
12000000001
1000N000001
11111111111
