1111111
1000001
1011101
1110111
1100011
10000011111111
100N0000000001
10000011111111
1111111
