1111111
1000001
1011101
1110111
1111111
10000011111111
10000010000001
100N0011111111
1111111
